┏_______________________┓
iOOOOOOOOOOOOOOOOOOOOOOO|
iOOOOOOOOOOOOOOOOOOOOOOO|
iOOOOOOOOOOOOOOOOOOOOOOO|
iOOOOOOOOOOOOOOOOOOOOOOO|
iOOOOOOOOOOOOOOOOOOOOOOO|
iOOOOOOOOOOOOOOOOOOOOOOO|
iOOOOOOOOOOOOOOOOOOOOOOO|
iOOOOOOOOOOOOOOOOOOOOOOO|
iOOOOOOOOOOOOOOOOOOOOOOO|
iOOOOOOOOOOOOOOOOOOOOOOO|
iOOOOOOOOOOOOOOOOOOOOOOO|
iOOOOOOOOOOOOOOOOOOOOOOO|
iOOOOOOOOOOOOOOOOOOOOOOO|
iOOOOOOOOOOOOOOOOOOOOOOO|
iOOOOOOOOOOOOOOOOOOOOOOO|
iOOOOOOOOOOOOOOOOOOOOOOO|
iOOOOOOOOOOOOOOOOOOOOOOO|
┗-----------------------┛
Legend:(char:file:collision)
┏:Tiles/whiteWall2NW:true
┓:Tiles/whiteWall2NE:true
┗:Tiles/whiteWall2SW:true
┛:Tiles/whiteWall2SE:true
_:Tiles/whiteWall2N:true
-:Tiles/whiteWall2S:true
|:Tiles/whiteWall2E:true
i:Tiles/whiteWall2W:true
O:Tiles/brownMarble:false